forehead	brow
believable	plausible
ignore	disregard
equity	fairness
unstated	unspoken
cheesy	corny
numerous	many
put back	postpone
pressing	urgent
foretell	predict
gut	intestine
testament	testimony
near	approach
liveable	habitable
soiled	dirty
a narrative	a story
exactly	precisely
enquire	investigate
constitution	structure
dossier	file
vary	differ
matters	things
self-assured	confident
constant	fixed
withstand	resist
business	commerce
stable	steady
maybe	perhaps
noon	midday
provided	if
isolated	lonely
clerk	receptionist
home	domestic
quake	tremble
particular	specific
moderately	reasonably
inconsiderate	thoughtless
glitter	sparkle
explode	blow up
homicide	murder
begin	start
possibility	opportunity
murderer	assassin
differentiate	distinguish
hurry	rush
lousy	awful
off-season	low season
madness	insanity
vanquish	conquer
constancy	fidelity
intend	mean
fortunate	lucky
mimic	imitate
daybreak	dawn
illiberal	intolerant
detached	indifferent
mendacity	lying
second	moment
uncared for	neglected
mind	intellect
reliable	dependable
happily	fortunately
select	choose
butt	bottom
terror	terrorism
hunger	starvation
invoice	bill
middleman	intermediary
infect	contaminate
mo 	moment
disclose	reveal
usually	normally
man made	artificial
deserted	abandoned
scarcity	shortage
uninjured	unhurt
non-stop	continuous
unforeseen	unexpected
modern	contemporary
bloodbath	massacre
sunrise	dawn
essential	fundamental
visualize	imagine
leading	main
delicate	fragile
insolvent	bankrupt
silly	foolish
more and more	increasingly
overhaul	overtake
knowingly	deliberately
if	whether
magician	conjuror
impeach	question
grouse	grumble
confederate	accomplice
class	lesson
temper	mood
economic	profitable
peaceable	peaceful
immediate	instant
crusade	campaign
nugatory	worthless
outside	external
innocent	harmless
immoderate	excessive
chop	cut
mindless	senseless
lacking	missing
imperative	vital
a native	a local
nameless	anonymous
pattern	sample
stupid	silly
expire	run out
formerly	previously
citation	quotation
domesticate	cultivate
vain	useless
undeniable	indisputable
miserable	depressing
behave	act
assure	guarantee
sacristy	vestry
symbolize	represent
insufficient	inadequate
informal	casual
twister	tornado
interplay	interaction
previous	preceding
lethal	deadly
garbage can	trash can 
chorus	refrain
fanatic	enthusiast
imagine	assume
hand out	distribute
virtue	advantage
infamous	notorious
vacuum	hoover
remark	comment
operate	function
transitory	temporary
unlawful	illegal
deprave	corrupt
hole	gap
touchdown	landing
mannequin	model
noted	famous
well mannered	polite
zenith	peak
fantastic	great
obligatory	compulsory
answer	reply
convey	communicate
imitate	mimic
involve	entail
idler	loafer
fool	idiot
disaster	catastrophe
in the meantime	meanwhile
extra	additional
deceptive	misleading
complete	total
hawk	peddle
organic	biological
receive	get
denote	indicate
discount	reduction
priority	precedence
grab	seize
inventory	stock
devil	satan
insufferable	unbearable
gay	homosexual
hint	tip
vague	indistinct
enormous	huge
touchy	sensitive
impassive	emotionless
midway	halfway
cope	manage
remainder	the rest
impolite	rude
cussed	stubborn
painting	portray
dubious	doubtful
misery	distress
tailored	tailor-made
especially	particularly
gravestone	headstone
away	absent
deduce	infer
association	organization
transform	convert
depraved	wicked
sure	certain
dicy	risky
annoy	irritate
establish	set up
denationalize	privatize
migrate	emigrate
inheritor	heir
insupportable	intolerable
uprising	rebellion
mirror	reflect
hearsay	rumour
meeting	assembly
torpid	lethargic
curler	roller
fabricate	manufacture
moreover	in addition
remorse	regret
skull	cranium
notify	inform
defective	faulty
unvoiced	voiceless
evaluate	assess
foolish	silly
omnipotent	all-powerful
hypothesis	speculation
bloodless	cold
impartial	neutral
repute	reputation
nominate	appoint
concord	harmony
connect	associate
notwithstanding	however
dash	sprint
branch	department
disagreeable	unpleasant
decontrol	deregulate
consult	refer to
practically	virtually
jealous	envious
naked	bare
gratuity	tip
suggest	propose
garbage	rubbish
curative	healing
well timed	timely
measure	degree
prompt	immediate
praise	compliment
french dressing	vinaigrette
hall	corridor
material	fabric
comfort	consolation
precedence	priority
reminiscence	memory
confuse	mix up
approximately	almost
hashish	cannabis
hang-out	haunt
backside	behind
livid	furious
necessary	essential
removable	detachable
hazard	endanger
unmarried	single
overlook	miss
confine	restrict
napkin	serviette
post-mortem	autopsy
continuous	continual
grasping	greedy
spotlight	highlight
categorize	classify
encounter	come across
illuminate	clarify
substantially	considerably
elevate	raise
bad (not good)	poor
passable	satisfactory
inflow	influx
intellectual	mental
lucid	clear
insurgent	rebel
signal	sign
ornament	decoration
warranty	guarantee
foxy	cunning
infrequent	rare
intensify	heighten
untrue	unfaithful
loopy	crazy
brow	forehead
handsome	good-looking
scrumptious	delicious
last	final
float	drift
chiefly	mainly
revolting	disgusting
cite	quote
comic	comedian
illustrate	demonstrate
earth	soil
diminish	decrease
cube	dice
nightfall	dusk
beat	defeat
rude	impolite
candy	sweet
reasonable	fair
conform	comply
immobile	motionless
satisfied	convinced
arrive	reach
surroundings	environment
hermetic	airtight
infantile	childish
precis	summary
joy	delight
clever	intelligent
dull (person)	stupid
rue	regret
close	shut
admit	confess
except	apart from
impediment	obstacle
object	thing
blameless	innocent
eager	keen
selection	choice
choosy	picky
function	operate
sincere	honest
untimely	premature
vast	huge
narrate	relate
steady	regular
inspect	examine
coiffure	hairstyle
immodest	conceited
backbone	spine
charter	constitution
legitimate	valid
pocket book	notebook
convention	conference
uncommon	unusual
transparent	obvious
brave	courageous
minimize	play down
missing	lost
collect	gather
maintain	preserve
significant	meaningful
disappear	vanish
denims	jeans
mistrust	distrust
nobility	aristocracy
awful	terrible
attractive	appealing
considerate	thoughtful
condemn	sentence
today	nowadays
movie	film
paper money	notes
destiny	fate
crook	criminal
commencement	graduation
instinct	intuition
trustworthy	reliable
learn	memorize
fragrance	perfume
contrary	opposite
renounce	give up
magnify	exaggerate
highbrow	intellectual
belly	stomach
renew	resume
refrain	chorus
respond	reply
bum	backside
conflict	clash
twosome	pair
merciless	cruel
everlasting	eternal
valueless	worthless
hard	tough
desert	abandon
unfortunate	unlucky
prosperous	affluent
couch	sofa
rubbish	nonsense
religious	devout
survive	outlive
completely	totally
deliberate	planned
almost	nearly
unusual	strange
sundown	sunset
instructions	directions
appear	arrive
bizarre	weird
impasse	deadlock
famous	famed
quite	fairly
mild	gentle
misread	misinterpret
uncooked	raw
ultimate	final
perception	insight
phantasm	illusion
disclaim	deny
oversee	supervise
disadvantaged	deprived
disgrace	shame
unhurt	unharmed
collapse	break down
obsolete	out of date
demonstrate	protest
winery	vineyard
housebreaking	burglary
oblique	indirect
overseas	abroad
impact	affect
indisputable	undeniable
poisonous	toxic
egocentric	selfish
correct	right
precept	principle
contemporary	modern
accomplish	achieve
dedicated	committed
provide	supply
vacancy	emptiness
obdurate	stubborn
foyer	lobby
inflexible	rigid